...###
..##.######
.##.......#
##..@..+..##############
#......................#
#.....c................#
#.........##############
.##..#.#.##
.#..+...##
.#.....##
.###.+##########
.#.............#
.#.............#
#..............#
#.......B......#
#..............#
#..............#
################
