...###
..##.######
.##.......#
##..@..+..##############
#......................#
#.....c................#
#.........######..######
.##..#.#.##............#
.#..+...##........e....#
.#.....##..............#
.###.+##################
.#.............#
.#.............#
#..............#
#.......B......#
#..............#
#..............#
################
