...###
..##.######
.##.......#
##..@..+..##############
#....c.................#
#.........##############
#.........#
.##.##.#.##
.#..+...##
.#.....##
.####+##########
.#.............#
.#.............#
#..............#
#.......B......#
#..............#
#..............#
################
