####################
#..................#
#.........e...e....#
#....e.............#
#........e...e.....#
#...e..............#
#.......e...e......#
#..e...............#
#..................#
#........@.........#
#..................#
#..................#
#...............c..#
#..................#
#########...########
#............e.....#
#..................#
#..................#
#..................#
#...e..............#
#.........B........#
####################