light day
###############
#......#......#
#..........T..#
###..###......#
#......#......#
#.b....#....@.#
#......#......#
###############
end