light day
###############
#......#......#
#......#......#
#.b....#.@....#
#......#......#
#......#......#
#......#......#
###############
end