###############
#.............#
#.............#
#........@....#
#.............#
#.............#
#.............#
###############