light day
###############
#......#......#
#.............#
###..###......#
#......#......#
#.b....#....@.#
#......#......#
###############
end